111111111111111
100101000000001
1001C1000C00001
100101000000001
1000C0000010001
1000000001C1001
100000110001111
100P0000C100001
100000000100E01
111111111111111