111111111111111
100101000000001
1001C1000C00001
100101000000001
1000C0000000001
1000000000C0001
100000111000E01
100P0000C000001
100000000000001
111111111111111