111111111111111
100000000000001
100000000C00001
100000000000001
100000000000001
100000000000001
100000000000E01
100P00000000001
100000000000001
111111111111111