111111111111111111
1C010000000C111
110001111100
1P0011E0000011
1111111111111111