1111111111111
1C01000E000C1
1100011111001
1P0011E000001
1111111111111