1111111111111
1001000000001
1100011111001
1P0011E000001
1111111111111