111111111111111
100101000000001
100101000000001
10110100000C001
100000000010001
100000000101001
100000110001111
100P00000000001
100000000100E01
111111111111111